Level2D
8
9
@########
#   #####
# @  ####
## @ ####
####Ao  #
###  o# #
###     #
#########