Level2D
8
9
#########
#   #####
# @  ####
## @ ####
####A  o#
###  #  #
###    o#
#########