Level2D
10
10
##########
#o     @ #
#  ##### #
####     #
#        #
#  A     #
#        #
#      @ #
#o       #
##########