Level2D
6
6
######
#o  ##
#A@@ #
#    #
##   #
####o#
######