Level2D
10
10
##########
#        #
#  #   # #
#o #     #
#  @o    #
#  A     #
#   @    #
#        #
#        #
##########